11111111111111111
10P0000C1100000E1
10000000000000001
10000110011111001
10C00000C0C100001
11111111111111111
