11111111111111111
1ECP0000110000001
10000000000000001
10000110011111001
10000000000100001
11111111111111111
