11111111111111111
1P00P001P100000P1
10000000000000001
10000000010000001
1P0000000P00000P1
10000000010000001
10000000000000001
10000001P10000001
11000000000000011
1P0000000E00000P1
11000000P00000011
10000000000000001
1P00P00001P1000P1
11111111111111111
