11111111111111111111111111111111111111111111111111
10000000000000000000000000001110000000000000000001
10000110000110000000000000011100000110000000000001
10000110000110000001111111111111111100000000000001
10000110000110000011111111111111111000000000000001
10000110000110000000000000011100000000000000000001
10000110000110000000000000001110000000000000000001
10000110000110000000000000000000000000000000000001
10000110000110000000000000000000000000000000000001
10000110000110000000000000000000000000000000000001
11111111111111111111111111111111111111111111111111
