11111111111111111
10P000001100000E1
1000C000000C00001
10000110000011001
10C000C000C000001
11111111111111111
