111111111111111111
10P0000011000000E1
1000000C0000000001
100001100000011001
10C0000000C0000001
111111111111111111