11111111111111111
10P000001100000E1
1000000C000000001
10000110000011001
10C0000000C000001
11111111111111111
