11111
11111
11111
11111
11111
11111
11111
11111
11111
11111
11111
11111
11111
