111111111
101000001
101000001
101000001
101000001
111111111
