1111111111111111111111111111111
1000000000000110000000000000001
1011110111110110111111011111101
1010000100000000000000010000101
1010111101111000111111011101101
1000100000000000000000000000001
1111111111111111111111111111111
