11111111111111111
1C00C001C100000C1
10000000000000001
10000000010000001
1C0000000C00000C1
10000000010000001
10000000000000001
10000001P10000001
10000000000000011
1C0000000E00000C1
10000000C00000011
10000000000000001
1C00C00001C1000C1
11111111111111111
