111111111111111111111111111111111111
100011100000000000000000000000000001
100000000000000011111110000000000001
100000111111000000011000011000000001
100000000000111110000001110000000001
100000000111110000001111110000001101
100000000000000000110000011111111101
100000000000000111111111000000000101
100000000000000000000000000000000101
111111111111111111111111111111111111
