111111111111111111111111111111111111111111111
100000000000000000000001110000000000000000001
100001100001100000000011100000110000000000001
100001100001101111111111111111100000000000001
100001100001111111111111111111000000000000001
100001100001100000000011100000000000000000001
100001100001100000000001110000000000000000001
100001100001100000000000000000000000000000001
100001100001100000000000000000000000000000001
100001100001100000000000000000000000000000001
111111111111111111111111111111111111111111111
