11111111111111111111111111111111111111111
10000000000000000001100000000000000000001
10000000000000000001100000000000000000001
11111000000000000001100000000000000011111
10011111111000000001100000001111111110001
10000000111111110001100011101111100000001
10000000000000001110011100000000000000001
10000000000000000000000000000000000000001
10000000000000000001100000000000000000001
10000000000000000110011000000000000000001
10000000000000000110011000000000000000001
10000000000000000110011000000000000000001
10000000000000000110011000000000000000001
10000000000000000110011000000000000000001
10000000000000000110011000000000000000001
10000000000000000110011000000000000000001
10000000000000000110011000000000000000001
10000000000000000110011000000000000000001
10000000000000000111111111110000000000001
10000000000011111111111111110000000000001
10000000000011111110000111111100000000001
10000000000011111110000111111100000000001
11111111111111111111111111111111111111111
