11111111111111111
10P000001100C00E1
10000N0000N0000N1
1000011000C011001
10C0N00000C000NN1
11111111111111111
